NO ./ressource/textures/TECH_3G.xpm
SO ./ressource/textures/TECH_0F.xpm
WE ./ressource/textures/TECH_3D.xpm
EA ./ressource/textures/TECH_1F.xpm

C 15, 15, 15
F 20, 20, 20

        1111111111111111111111111
        1E00000000110000000000001
        1011000001110000000000001
        1001000000000000000000001
111111111011000001110000000000001
100000000000000001110111111111111
11110111111111011100000010001
11110111111111011101010010001
110000001101010111000000000001
10000000000000000000000010001
100000000000000000010100100001
110000011101010111110111100111
11110111 1110101 101111010011
11111111 1111111 11111111111